X..OOOOO.O..OOO
.O.....O.OO.OOO
..OO.O...O..OOO
O...OOOO...OOOO
...O.....OOO..O
OO.OOOO.OO...OO
...OOO....OOOOO
.O...OO.O.OO..O
.OO.O...O...OOO
OOO..OOOO.OOOOO
OOO.OO.O..OO..O
O...O..O.OO..OO
..OO..O.....OOO
OOOOO.OO.OO.OOO
O....OOO..O...U
